PPPPWWWP
PPPWWPPP
PPWWPPPP
PWWPPFFF
WWPPFFFF
FWWPPFFF
FFWWPPFF
FFFWWPPF
FFFMWWMF
FPPMMWWM
PPPFMWWM
MPFFMWWM
MPPFMWWM
MMPMMWWM
MMMMMWWM
---UNITS---
KNIGHT,5,4,PLAYER
MAGE,6,7,PLAYER
RANGER,2,7,PLAYER
KNIGHT,1,1,CPU